04 ...C.....CD.AA.CD..BBB.............. 89
04 .EBBB..E..F..EAAF...xDD............. 88
04 .....D.....DAA...D..............BBCC 87
04 BBBx....G...AAG...FDD.x.F........... 84
04 BBB.E...D.E.AAD...........x......... 84
04 ...........xAA...E.....E.CCCDD...... 22
04 .BBCCC.....DAA...D.....E.....E.....E 21
04 .......BBBCCAA...E.....E.....x...... 21
04 .BBCCC.....FAA...F..xEEE............ 17
