1 ....B.....B.AA......................
1 ............AA......C.....C.........
3 .BBx.....LDDJAAL..J..EEMFF...MGGHHHM
2 .x..MNDDDKMNAA.K.....EE.IFFL..IGGL.x
2 ...BLM.H.BLMGH.AANGDDK.NG.JK..FFJ...
2 .xCCM.DDDKM.AA.K......EEIFF..NIGG.xN
1 ...B.....B..AA........C.....C.....C.
4 ..KBBBCCKLMNJAALMNJ.....EE....HHHII.
1 .....B.....BAA......C.....C.....C...
1 ............AA......................
5 ..b.....b...aabd...ccd..f..d..f..ee.